{
    "science": {
      "id": "scienceOffline",
      "name": "The offline Science!",
      "size": "13x18",
      "map": [
        [1, 1, 1, 1, 0, 0, 0, 0, 0, 1, 1, 1, 1],
        [1, 1, 0, 0, 1, 1, 1, 1, 1, 0, 0, 1, 1],
        [1, 0, 1, 1, 1, 1, 1, 1, 1, 1, 1, 0, 1],
        [0, 1, 1, 1, 0, 1, 1, 1, 0, 1, 1, 0, 1],
        [0, 1, 1, 1, 0, 0, 0, 0, 0, 0, 1, 1, 0],
        [0, 1, 1, 0, 1, 1, 0, 1, 1, 0, 1, 1, 0],
        [0, 1, 1, 0, 0, 1, 1, 1, 0, 0, 1, 1, 0],
        [0, 1, 1, 1, 0, 1, 1, 1, 0, 1, 1, 1, 0],
        [1, 0, 1, 1, 0, 0, 1, 1, 0, 1, 1, 0, 1],
        [1, 1, 0, 1, 1, 0, 1, 0, 0, 1, 0, 1, 1],
        [1, 1, 1, 0, 1, 0, 1, 0, 1, 0, 1, 1, 1],
        [1, 1, 1, 0, 0, 0, 0, 0, 0, 0, 1, 1, 1],
        [1, 1, 1, 1, 0, 0, 0, 0, 0, 1, 1, 1, 1],
        [1, 1, 1, 0, 1, 1, 1, 1, 1, 0, 1, 1, 1],
        [1, 1, 1, 0, 0, 0, 0, 0, 0, 0, 1, 1, 1],
        [1, 1, 1, 0, 1, 1, 1, 1, 1, 0, 1, 1, 1],
        [1, 1, 1, 1, 0, 0, 0, 0, 0, 1, 1, 1, 1],
        [1, 1, 1, 1, 1, 0, 0, 0, 1, 1, 1, 1, 1]
      ]
    }


}

